1.202  1
1.203  1
1.205  1
1.206  1
1.211  1
1.212  1
1.214  1
1.215  1
1.229  1
1.230  1
1.232  1
1.233  1
1.238  1
1.239  1
1.241  1
1.242  1
